1111111111111111
1C0100000000C011
1000011111000001
1P0011E000001001
1000000000000001
1000000000000001
1111011100001001
10C0000C100000C1
1111111111111111
