11111111
10000001
100C0001
100E0001
10000001
10C00P01
11111111