11111111
10000001
10XC0001
10LE0001
10000001
10C00P01
11111111