1111111111111111111111
10000000000000000001X1
10111L1111111111110001
101X1110000000000000X1
1C00100000000000011111
111X101000000000000001
1C0000100000E000001001
1101000000000000000001
100X011000000000001101
100001C000000000000X01
101101001101101111C011
1P1C011C0000C000X10XC1
1111111111111111111111